%%%%%%%%%%%%%%%%%%%%%
%o  ....        P .o%
%.%o.%%  %o%%.%%.%. %
%..     ..          %
%%%%%%%%%%%%%%%%%%%%%