%%%%%%%%%%%%%
%     .%.  o%
% %%. .%%. %%
%.%o       .%
%o%%. .%%%  %
%....    P.o%
%%%%%%%%%%%%%
